//MAP CONVERTED BY dmm2tgm.py THIS HEADER COMMENT PREVENTS RECONVERSION, DO NOT REMOVE
"a" = (
/turf/unsimulated/dirt,
/area/space)
"C" = (
/turf/simulated/floor/auto/sand,
/area/space)
"H" = (
/turf/unsimulated/wall/trench/side,
/area/space)
"W" = (
/turf/unsimulated/wall/trench,
/area/space)

(1,1,1) = {"
a
a
a
C
C
C
C
a
a
a
a
a
a
a
a
a
"}
(2,1,1) = {"
a
a
a
C
C
C
C
a
a
a
a
a
a
a
a
a
"}
(3,1,1) = {"
a
a
a
C
C
C
C
C
C
C
a
a
a
a
a
a
"}
(4,1,1) = {"
a
a
a
a
a
C
C
C
C
C
a
a
a
a
a
a
"}
(5,1,1) = {"
a
a
a
a
a
C
C
a
C
C
C
C
C
a
a
a
"}
(6,1,1) = {"
W
a
a
a
a
a
a
a
C
C
C
C
C
C
a
a
"}
(7,1,1) = {"
W
W
H
a
a
a
a
a
C
C
C
C
a
C
a
a
"}
(8,1,1) = {"
W
H
a
a
a
a
a
a
a
C
C
a
C
C
a
a
"}
(9,1,1) = {"
W
W
H
a
a
a
a
a
a
a
a
a
C
C
a
a
"}
(10,1,1) = {"
W
W
W
H
a
a
a
a
W
W
H
a
a
a
W
W
"}
(11,1,1) = {"
W
W
W
H
a
a
a
a
W
W
a
a
a
a
W
W
"}
(12,1,1) = {"
W
W
W
W
H
a
a
a
W
W
a
W
W
W
W
W
"}
(13,1,1) = {"
W
W
W
H
a
a
a
a
W
W
a
W
W
W
W
W
"}
(14,1,1) = {"
W
W
H
a
a
a
a
a
W
W
a
W
W
W
W
W
"}
(15,1,1) = {"
W
W
W
H
a
a
a
a
W
W
a
W
W
W
W
W
"}
(16,1,1) = {"
W
W
W
H
a
a
a
a
W
H
a
W
W
W
W
W
"}
(17,1,1) = {"
W
W
H
a
a
a
a
a
W
H
a
W
W
W
W
W
"}
(18,1,1) = {"
W
W
H
a
a
a
a
a
W
H
a
W
W
W
W
W
"}
(19,1,1) = {"
W
W
W
H
a
a
a
a
W
H
a
W
W
W
W
W
"}
(20,1,1) = {"
W
W
W
W
a
a
a
W
W
H
W
W
W
W
W
W
"}
(21,1,1) = {"
W
W
W
W
a
a
a
W
W
W
W
W
W
W
W
W
"}
(22,1,1) = {"
W
W
W
W
a
a
a
a
W
W
W
W
W
W
W
W
"}
(23,1,1) = {"
W
W
W
W
a
a
a
a
W
W
W
W
W
W
W
W
"}
(24,1,1) = {"
W
W
W
W
a
a
a
W
W
W
W
W
W
W
W
W
"}
(25,1,1) = {"
W
W
W
W
a
a
a
W
W
W
W
W
W
W
W
W
"}
(26,1,1) = {"
W
W
W
W
a
a
a
W
W
W
W
W
W
W
W
W
"}
(27,1,1) = {"
W
W
W
W
W
W
W
W
W
W
W
W
W
W
W
W
"}
(28,1,1) = {"
W
W
W
W
W
W
W
W
W
W
W
W
W
W
W
W
"}
(29,1,1) = {"
W
W
W
W
W
W
W
W
W
W
W
W
W
W
W
W
"}
(30,1,1) = {"
W
W
W
W
W
W
W
W
W
W
W
W
W
W
W
W
"}
(31,1,1) = {"
W
W
W
W
W
W
W
W
W
W
W
W
W
W
W
W
"}
(32,1,1) = {"
W
W
W
W
W
W
W
W
W
W
W
W
W
W
W
W
"}
